########################################
#*******#******************************#
#*******#******************************#
#*******#****************###***********#
#*******#*******S********###***********#
#*******#******************************#
#*******#*************************G****#
#*******#******************************#
#*******##########d########************#
#*******#***#*************#************#
#*******#***#*************#************#
#*************************######*******#
#***************************#**********#
#***************************#**********#
#***************************#**********#
#***************************#**********#
#***************************D**********#
#**********************#**##############
#**********************#**#************#
#**********************#**#************#
#**********************####************#
#**************************************#
#**************************************#
#**************************************#
#**************************************#
#**************************************#
#**************************************#
#*****************##*******************#
#****************#**#******************#
#****************#*********************#
#*****************#***#****************#
#******************#***#***************#
#******#####********#**#***************#
#******#***#*********##****************#
#******#***#***************************#
#**********#***************************#
#******#####***************************#
#**************************************#
#**************************************#
########################################