########################################
##*************************************#
#**************************************#
#**************************************#
#**************************************#
#**************************************#
#**************************************#
#**************************************#
#**************************************#
#**************************************#
#**************************************#
#**************************************#
#**************************************#
#**************************************#
#**************************************#
#**************************************#
#**************************************#
#**************************************#
#**************************************#
#**************************************#
#**************************************#
#**************************************#
#**************************************#
#**************************************#
#**************************************#
#**************************************#
#**************************************#
#**************************************#
#**************************************#
#**************************************#
#**************************************#
#**************************************#
#**************************************#
#**************************************#
#**************************************#
#**************************************#
#**************************************#
#**************************************#
#**************************************#
########################################