########################################
#**************************************#
#**************************************#
#**************************************#
#****#*********************************#
#****#*****************#####***********#
#****#**********************#**********#
#****#**********************#**********#
#****#******************#####**********#
#****#*****************#***************#
#****#*****************#***************#
#****########**********######**********#
#**************************************#
#**************************************#
#**************************************#
#**************************************#
#**************************************#
#**************************************#
#**************************************#
#**************************************#
#**************************************#
#**************************************#
#**************************************#
#**************************************#
#**************************************#
#**************************************#
#**************************************#
#**************************************#
#**************************************#
#**************************************#
#**************************************#
#**************************************#
#**************************************#
#**************************************#
#**************************************#
#**************************************#
#**************************************#
#**************************************#
#**************************************#
########################################